NO ./TEXTURE/kita.xpm
SO ./TEXTURE/minami.xpm
WE ./TEXTURE/nishi.xpm
EA ./TEXTURE/higashi.xpm

F 85,107,47
F 85,107,47
C 30,144,255

11111111111111111
10000000000000001
10000000000000001
10000000000000001
100000N0000000001
10000000000000001
10000000000000001
10000000000000001
11111111111111111