NO ./img/collect.xpm
SO ./img/exit.xpm
WE ./img/tile.xpm
EA ./img/wall.xpm
F 220,100,0
C 225,30,0
1000W00111
 111111