NO ./img/collect.xpm
SO ./img/exit.xpm
WE ./img/tile.xpm
EA ./img/wall.xpm
F 220,100,0
C 225,30,0
        
 11111111 
10000000N1
1000000001
1000000001
1000000001
1000000001
1000000001
1000000001
1000000001
1000000001
 11111111
