NO ./img/collect.xpm
SO ./img/exit.xpm
WE ./img/tile.xpm
EA ./img/wall.xpm
F 220,100,0
C 225,30,0
1111111111
1010001001
1010001001
1010010001
10001N1001
1000110001
1000100001
1000000001
1000000101
1111111111