NO ./img/collect.xpm
SO ./img/exit.xpm
WE ./img/tile.xpm
EA ./img/wall.xpm
F 220,100,0
C 225,30,0
        
11111111111
1000001111
111100011
1N00000111
 111111                             
